NO ./texture/wall/north.xpm
SO ./texture/wall/south.xpm
WE ./texture/wall/west.xpm
EA ./texture/wall/east.xpm

F 220,100,0
C 225,30,0

11111111111111       11111111111111111111111111111111111111111111
10000000000001       10011111111111111100000011110000001000000011
10000000000001       10011111111111110000001111110000111000000011
10000000000001       10011111111111000000111111110011111000000011
10000000000001       10011111111100000011111111111111111000000011
10111111111001       10011111100000001111111111111111100000001111
10111111111001       10011110000000111111111111111110000000111111
10000000000001       10011000000011111111111111111000000011111111
10000000000001       10010000000000000000000001110000000111110111
10111111111001       10010000000000000000000001110000000111100011
10111111111001       10010000000000000000000001110000000110000011
10000000000001       10011111111111111100000001111111111111111111
10000000000001       10011111111111111100000001111111111111111111
10111111111001       10011111111111111100000001111111111111111111
10111111111001       10011111111111111111111111111111111111111111
10000000000001       10001
10000000000001       10011
10111111111001       1001
10111111111001       10011
10000000000001       10001
10000000000001       10011
10111111111001       1001
10111111111001       1001
1000000000000111111111001
10111111111000000000W0001
1000000000000000011111001                         1111
100111111111110001   1001                         1001
100111111111110001   1001                         1001
100000000000000001   1001                         1001
100000000000000011   1001                         1001
100111111111110011   1001                         1001
100111111111110011   1001                         1001
100000000000000001   1001                         1001
100000000000000001   1001            111 111      1001
100111111111110001   1001           110111011111110001
100111111111110001   1001           1             0001
110000000000000001   1001           1             0001
110000000000000001   1001           1             0001
100111111111110001   1001           1             0001
100111111111110001   1001           1             1001
100000000000000001   1001           110111011111110001
100000000000000001   1001            111 111      1001
100111111111110001   1001                         1001
100111111111110001   1001                         1001
100000000000000001   1001                         1001
100000000000000001   1001                         1001
100000000000000001   100111111111111111111111111111001
100000000000000001   100000000000000000000000000000001
100000000000000001   100000000000000000000000000000001
111111111111111111   111111111111111111111111111111111
